BUFSIZ                        	<stdio.h>
CHAR_BIT                      	<limits.h>
CHAR_MAX                      	<limits.h>
SIZE_MAX                      	<limits.h>
CLOCKS_PER_SEC                	<time.h>
DBL_DIG                       	<float.h>
DBL_EPSILON                   	<float.h>
DBL_MANT_DIG                  	<float.h>
DBL_MAX                       	<float.h>
DBL_MIN                       	<float.h>
DBL_MIN_10_EXP                	<float.h>
DBL_MIN_EXP                   	<float.h>
DECIMAL_DIG                   	<float.h>
EBADMSG                       	<errno.h>
EBUSY                         	<errno.h>
ECANCELED                     	<errno.h>
EDEADLK                       	<errno.h>
EDOM                          	<errno.h>
EEXIST                        	<errno.h>
EFAULT                        	<errno.h>
EFBIG                         	<errno.h>
EINPROGRESS                   	<errno.h>
EINTR                         	<errno.h>
EIO                           	<errno.h>
EMLINK                        	<errno.h>
ENAMETOOLONG                  	<errno.h>
ENOEXEC                       	<errno.h>
ENOLCK                        	<errno.h>
ENOSYS                        	<errno.h>
ENOTEMPTY                     	<errno.h>
ENOTTY                        	<errno.h>
EOF                           	<stdio.h>
EPERM                         	<errno.h>
EROFS                         	<errno.h>
ESPIPE                        	<errno.h>
ESRCH                         	<errno.h>
ETIMEDOUT                     	<errno.h>
EXIT_FAILURE                  	<stdlib.h>
EXIT_SUCCESS                  	<stdlib.h>
FE_DFL_ENV                    	<fenv.h>
FE_INEXACT                    	<fenv.h>
FE_TOWARDZERO                 	<fenv.h>
FE_UNDERFLOW                  	<fenv.h>
FE_UPWARD                     	<fenv.h>
FILE                          	<stdio.h>
FLT_DIG                       	<float.h>
FLT_EPSILON                   	<float.h>
FLT_EVAL_METHOD               	<float.h>
FLT_MAX_10_EXP                	<float.h>
FLT_ROUNDS                    	<float.h>
FP_FAST_FMAL                  	<math.h>
FP_INFINITE                   	<math.h>
FP_NAN                        	<math.h>
FP_SUBNORMAL                  	<math.h>
FP_ZERO                       	<math.h>
HUGE_VAL                      	<math.h>
INT_MAX                       	<limits.h>
INT_MIN                       	<limits.h>
LC_ALL                        	<locale.h>
LC_CTYPE                      	<locale.h>
LC_MONETARY                   	<locale.h>
LC_NUMERIC                    	<locale.h>
LC_TIME                       	<locale.h>
LDBL_DIG                      	<float.h>
LDBL_MAX                      	<float.h>
LDBL_MAX_10_EXP               	<float.h>
LDBL_MIN                      	<float.h>
LDBL_MIN_10_EXP               	<float.h>
LDBL_MIN_EXP                  	<float.h>
LLONG_MAX                     	<limits.h>
LONG_MAX                      	<limits.h>
LONG_MIN                      	<limits.h>
MB_LEN_MAX                    	<limits.h>
NAN                           	<math.h>
NULL                          	<stddef.h> | <stdio.h> | <stdlib.h> | <string.h> | <time.h> | <wchar.h> | <locale.h>
RAND_MAX                      	<stdlib.h>
RTLD_BINDING_MAX              	<dlfcn.h>
RTLD_DEFAULT                  	<dlfcn.h>
RTLD_GLOBAL                   	<dlfcn.h>
RTLD_LAZY                     	<dlfcn.h>
RTLD_LOCAL                    	<dlfcn.h>
RTLD_NEXT                     	<dlfcn.h>
RTLD_NOLOAD                   	<dlfcn.h>
RTLD_NOW                      	<dlfcn.h>
SCHAR_MIN                     	<limits.h>
SHRT_MAX                      	<limits.h>
UCHAR_MAX                     	<limits.h>
USHRT_MAX                     	<limits.h>
WCHAR_MIN                     	<wchar.h>
_Complex_I                    	<complex.h>
_IOFBF                        	<stdio.h>
_IOLBF                        	<stdio.h>
_IONBF                        	<stdio.h>
_Imaginary_I                  	<complex.h>
_exit                         	<unistd.h> <stdlib.h>
abort                         	<stdlib.h>
abs                           	<stdlib.h>
acosh                         	<math.h>
alarm                         	<unistd.h>
alloca                        	<alloca.h>
and                           	<iso646.h>
and_eq                        	<iso646.h>
asin                          	<math.h>
asinh                         	<math.h>
assert                        	<assert.h>
atan                          	<math.h>
atan2                         	<math.h>
atanh                         	<math.h>
atexit                        	<stdlib.h>
atof                          	<stdlib.h>
atoi                          	<stdlib.h>
atoll                         	<stdlib.h>
btowc                         	<wchar.h>
calloc                        	<stdlib.h>
ceil                          	<math.h>
clearerr                      	<stdio.h>
clock                         	<time.h>
close                         	<unistd.h>
complex                       	<complex.h>
connect                       	<sys/socket.h>
cosh                          	<math.h>
ctermid                       	<stdio.h>
ctime                         	<time.h>
div                           	<stdlib.h>
div_t                         	<stdlib.h>
dladdr                        	<dlfcn.h>
dlerror                       	<dlfcn.h>
dlopen                        	<dlfcn.h>
dlsym                         	<dlfcn.h>
dlvsym                        	<dlfcn.h>
double_t                      	<math.h>
dup2                          	<unistd.h>
epoll_create                  	<sys/epoll.h>
errno                         	<errno.h>
execvp                        	<unistd.h>
exit                          	<stdlib.h>
exp                           	<math.h>
fabs                          	<math.h>
fclose                        	<stdio.h>
fcntl                         	<unistd.h> <fcntl.h>
feclearexcept                 	<fenv.h>
fegetenv                      	<fenv.h>
fegetexceptflag               	<fenv.h>
fegetround                    	<fenv.h>
feholdexcept                  	<fenv.h>
fenv_t                        	<fenv.h>
feraiseexcept                 	<fenv.h>
ferror                        	<stdio.h>
fesetenv                      	<fenv.h>
fesetround                    	<fenv.h>
fetestexcept                  	<fenv.h>
feupdateenv                   	<fenv.h>
fflush                        	<stdio.h>
fgetc                         	<stdio.h>
fgets                         	<stdio.h>
fgetwc                        	<stdio.h> <wchar.h>
fgetws                        	<wchar.h>
fileno                        	<stdio.h>
float_t                       	<math.h>
flock                         	<sys/file.h>
floor                         	<math.h>
fmod                          	<math.h>
fnmatch                       	<fnmatch.h>
fopen                         	<stdio.h>
fork                          	<unistd.h> <sys/types.h>
fpos_t                        	<stdio.h>
fprintf                       	<stdio.h>
fputc                         	<stdio.h>
fputs                         	<stdio.h>
fputwc                        	<stdio.h> <wchar.h>
fputws                        	<wchar.h>
fread                         	<stdio.h>
free                          	<stdlib.h>
frexp                         	<math.h>
fscanf                        	<stdio.h>
fsetpos                       	<stdio.h>
ftell                         	<stdio.h>
fwrite                        	<stdio.h>
gai_strerror                  	<sys/socket.h> <sys/types.h> <netdb.h>
getaddrinfo                   	<sys/socket.h> <sys/types.h> <netdb.h>
getc                          	<stdio.h>
getchar                       	<stdio.h>
getcontext                    	<ucontext.h>
getenv                        	<stdlib.h>
gethostbyname                 	<netdb.h>
getopt                        	<unistd.h>
getopt_long                   	<getopt.h>
getopt_long_only              	<getopt.h>
gets                          	<stdio.h>
getwc                         	<stdio.h> <wchar.h>
getwchar                      	<wchar.h>
glob                          	<glob.h>
globfree                      	<glob.h>
gmtime                        	<time.h>
hypot                         	<math.h>
imaginary                     	<complex.h>
int_fast16_t                  	<stdint.h>
int_fast32_t                  	<stdint.h>
int_fast64_t                  	<stdint.h>
int_fast8_t                   	<stdint.h>
int_least16_t                 	<stdint.h>
int_least32_t                 	<stdint.h>
int_least64_t                 	<stdint.h>
int_least8_t                  	<stdint.h>
intmax_t                      	<stdint.h>
intptr_t                      	<stdint.h>
isalnum                       	<ctype.h>
isalpha                       	<ctype.h>
isfinite                      	<math.h>
isinf                         	<math.h>
islower                       	<ctype.h>
isnan                         	<math.h>
isnormal                      	<math.h>
isspace                       	<ctype.h>
isupper                       	<ctype.h>
iswalnum                      	<wctype.h>
iswalpha                      	<wctype.h>
iswcntrl                      	<wctype.h>
iswctype                      	<wctype.h>
iswdigit                      	<wctype.h>
iswgraph                      	<wctype.h>
iswlower                      	<wctype.h>
iswprint                      	<wctype.h>
iswpunct                      	<wctype.h>
iswspace                      	<wctype.h>
jmp_buf                       	<setjmp.h>
kill                          	<signal.h>
ldexp                         	<math.h>
ldiv                          	<stdlib.h>
ldiv_t                        	<stdlib.h>
llabs                         	<stdlib.h>
localeconv                    	<locale.h>
log                           	<math.h>
log10                         	<math.h>
longjmp                       	<setjmp.h>
lstat                         	<unistd.h> <sys/types.h> <sys/stat.h>
malloc                        	<stdlib.h>
mblen                         	<stdlib.h>
mbrlen                        	<wchar.h>
mbrtowc                       	<wchar.h>
mbstate_t                     	<wchar.h>
mbstowcs                      	<stdlib.h>
mbtowc                        	<stdlib.h>
memchr                        	<string.h>
memcmp                        	<string.h>
memcpy                        	<string.h>
memmove                       	<string.h>
memrchr                       	<string.h>
memset                        	<string.h>
mktime                        	<time.h>
mmap                          	<sys/mman.h>
modf                          	<math.h>
munmap                        	<sys/mman.h>
nanosleep                     	<time.h>
nice                          	<unistd.h>
not_eq                        	<iso646.h>
offsetof                      	<stddef.h>
open                          	<sys/types.h> <sys/stat.h> <fcntl.h>
opendir                       	<dirent.h> <sys/types.h>
or                            	<iso646.h>
or_eq                         	<iso646.h>
pause                         	<unistd.h>
pclose                        	<stdio.h>
perror                        	<stdio.h>
pipe                          	<unistd.h>
popen                         	<stdio.h>
pow                           	<math.h>
printf                        	<stdio.h>
pthread_attr_init             	<pthread.h>
pthread_attr_setdetachstate   	<pthread.h>
pthread_attr_setstacksize     	<pthread.h>
pthread_create                	<pthread.h>
pthread_join                  	<pthread.h>
ptrdiff_t                     	<stddef.h>
putc                          	<stdio.h>
putchar                       	<stdio.h>
putenv                        	<stdlib.h>
puts                          	<stdio.h>
putwc                         	<stdio.h> <wchar.h>
putwchar                      	<wchar.h>
qsort                         	<stdlib.h>
raise                         	<signal.h>
rand                          	<stdlib.h>
read                          	<unistd.h>
readline                      	<readline/history.h> <stdio.h> <readline/readline.h>
realloc                       	<alloca.h> <stdlib.h>
regcomp                       	<regex.h>
regerror                      	<regex.h>
regfree                       	<regex.h>
remove                        	<stdio.h>
rename                        	<stdio.h>
round                         	<math.h>
sbrk                          	<unistd.h>
scanf                         	<stdio.h>
sched_get_priority_min        	<sched.h>
sched_getparam                	<sched.h>
sched_getscheduler            	<sched.h>
sched_rr_get_interval         	<sched.h>
sched_setparam                	<sched.h>
select                        	<sys/time.h> <unistd.h> <sys/types.h> <sys/select.h>
sem_init                      	<semaphore.h>
sem_post                      	<semaphore.h>
sem_t                         	<semaphore.h>
sem_wait                      	<semaphore.h>
setbuf                        	<stdio.h>
setjmp                        	<setjmp.h>
setlocale                     	<locale.h>
setrlimit                     	<sys/resource.h>
setsockopt                    	<sys/socket.h>
sigaction                     	<signal.h>
sigaddset                     	<signal.h>
sigdelset                     	<signal.h>
sigfillset                    	<signal.h>
signal                        	<signal.h>
sigpending                    	<signal.h>
sigprocmask                   	<signal.h>
sigsetjmp                     	<setjmp.h>
sigsuspend                    	<signal.h>
size_t                        	<stddef.h> | <stdio.h> | <stdlib.h> | <string.h> | <time.h> | <wchar.h>
sleep                         	<unistd.h>
snprintf                      	<stdio.h>
socket                        	<sys/socket.h>
sprintf                       	<stdio.h>
sqrt                          	<math.h>
srand                         	<stdlib.h>
sscanf                        	<stdio.h>
stat                          	<unistd.h> <sys/types.h> <sys/stat.h>
stderr                        	<stdio.h>
stdin                         	<stdio.h>
stdout                        	<stdio.h>
strcat                        	<string.h>
strchr                        	<string.h>
strcmp                        	<string.h>
strcpy                        	<string.h>
strerror                      	<string.h>
strlen                        	<string.h>
strncat                       	<string.h>
strncmp                       	<string.h>
strpbrk                       	<string.h>
strsignal                     	<string.h>
strspn                        	<string.h>
strstr                        	<string.h>
strtod                        	<stdlib.h>
strtok                        	<string.h>
strtok_r                      	<string.h>
strtol                        	<stdlib.h>
strtoul                       	<stdlib.h>
strtoull                      	<stdlib.h>
strtoumax                     	<inttypes.h>
sysconf                       	<unistd.h>
system                        	<stdlib.h>
tan                           	<math.h>
tanh                          	<math.h>
tcsetattr                     	<unistd.h> <termios.h>
termios                       	<unistd.h> <termios.h>
time                          	<time.h>
times                         	<sys/times.h>
tm                            	<time.h> | <wchar.h>
tmpfile                       	<stdio.h>
tmpnam                        	<stdio.h>
tolower                       	<ctype.h>
toupper                       	<ctype.h>
towlower                      	<wctype.h>
towupper                      	<wctype.h>
tzset                         	<time.h>
ucontext_t                    	<ucontext.h>
uint_fast16_t                 	<stdint.h>
uint_fast32_t                 	<stdint.h>
uint_fast64_t                 	<stdint.h>
uint_least16_t                	<stdint.h>
uint_least32_t                	<stdint.h>
uint_least64_t                	<stdint.h>
uintmax_t                     	<stdint.h>
uintptr_t                     	<stdint.h>
ungetwc                       	<wchar.h>
usleep                        	<unistd.h>
va_arg                        	<stdarg.h>
va_copy                       	<stdarg.h>
va_end                        	<stdarg.h>
va_list                       	<stdarg.h>
va_start                      	<stdarg.h>
vfscanf                       	<stdio.h> <stdarg.h>
vprintf                       	<stdio.h> <stdarg.h>
vsprintf                      	<stdio.h> <stdarg.h>
wait                          	<sys/wait.h> <sys/types.h>
waitpid                       	<sys/wait.h> <sys/types.h>
wchar_t                       	<stddef.h> | <wchar.h> | <stdlib.h>
wcrtomb                       	<wchar.h>
wcscat                        	<wchar.h>
wcschr                        	<wchar.h>
wcscmp                        	<wchar.h>
wcsncmp                       	<wchar.h>
wcsncpy                       	<wchar.h>
wcspbrk                       	<wchar.h>
wcsspn                        	<wchar.h>
wcsstr                        	<wchar.h>
wcstok                        	<wchar.h>
wcstrtoimax                   	<stddef.h> <inttypes.h>
wcstrtoumax                   	<stddef.h> <inttypes.h>
wctob                         	<wchar.h>
wctomb                        	<stdlib.h>
wctrans                       	<wctype.h>
wcwidth                       	<wchar.h>
wint_t                        	<wchar.h>
wmemcmp                       	<wchar.h>
wmemcpy                       	<wchar.h>
wmemmove                      	<wchar.h>
wmemset                       	<wchar.h>
write                         	<unistd.h>
